4 4 4 4 4 4 4 4 4 4 4 4 4 4 4 -1
4 4 4 4 4 4 4 4 4 4 4 4 4 4 4 -1
4 4 4 4 4 4 4 4 4 4 4 4 4 4 4 -1
4 4 4 4 4 4 4 4 4 4 4 4 4 4 4 -1
4 4 4 4 4 4 4 4 4 4 4 4 4 4 4 -1
4 4 4 4 4 4 4 4 4 4 4 4 4 4 4 4 4 4 4 4 -1
4 4 4 4 4 4 4 4 4 4 4 4 4 4 4 4 4 4 4 4 -1
4 4 4 4 4 4 4 4 4 4 4 4 4 4 4 4 4 4 4 4 -1
4 4 4 4 4 4 4 4 4 4 4 4 4 4 4 4 4 4 4 4 -1
4 4 4 4 4 4 4 4 4 4 4 4 4 4 4 -1
4 4 4 4 4 4 4 4 4 4 4 4 4 4 4 -1
4 4 4 4 4 4 4 4 4 4 4 4 4 4 4 -1
4 4 4 4 4 4 4 4 4 4 4 4 4 4 4 -1
4 4 4 4 4 4 4 4 4 4 4 4 4 4 4 -1
4 4 4 4 4 4 4 4 4 4 4 4 4 4 4 -1
-2
0 0 0 0 0 0 0 0 0 0 0 0 0 0 0 -1
0 8 8 8 8 8 8 8 8 8 8 8 8 8 0 -1
0 8 8 8 8 8 8 8 8 8 8 8 8 8 0 -1
0 8 8 8 8 8 8 8 8 8 8 8 8 8 0 -1
0 8 8 8 8 8 8 8 8 8 8 8 8 8 0 -1
0 8 8 8 8 8 8 8 8 8 8 8 8 8 0 6 2 0 0 0-1
0 8 8 8 8 8 8 8 8 8 8 8 8 8 0 0 0 0 6 0-1
0 8 8 8 8 8 8 8 8 8 8 8 8 8 0 0 6 0 0 0-1
0 8 8 8 8 8 8 8 8 8 8 8 8 8 0 6 2 0 2 0-1
0 8 8 8 8 8 8 8 8 8 8 8 8 8 0 -1
0 8 8 8 8 8 8 8 8 8 8 8 8 8 0 -1
0 8 8 8 8 8 8 8 8 8 8 8 8 8 0 -1
0 8 8 8 8 8 8 8 8 8 8 8 8 8 0 -1
0 8 8 5 5 8 8 8 8 8 8 8 8 8 0 -1
0 0 0 0 0 0 0 0 0 0 0 0 0 0 0 -1
-2
0 0 0 0 0 0 0 0 0 0 0 0 0 0 0 -1
0 8 8 8 8 8 8 8 8 8 8 8 8 8 0 -1
0 8 0 0 0 0 0 0 0 0 0 0 0 8 0 -1
0 8 0 0 0 0 0 0 0 0 0 0 0 8 0 -1
0 8 0 0 0 0 0 0 0 0 0 0 0 8 0 -1
0 8 0 0 0 0 0 0 0 0 0 0 0 8 0 -1
0 8 0 0 0 0 0 0 0 0 0 0 0 0 0 -1
0 8 0 0 0 0 0 0 0 0 0 0 0 0 0 -1
0 8 0 0 0 0 0 0 0 0 0 0 0 8 0 -1
0 8 0 0 0 0 0 0 0 0 0 0 0 8 0 -1
0 8 0 0 0 0 0 0 0 0 0 0 0 8 0 -1
0 8 0 5 0 0 5 0 0 0 0 0 0 8 0 -1
0 8 0 7 7 7 5 0 0 0 0 0 0 8 0 -1
0 8 8 8 5 5 8 8 8 8 8 8 8 8 0 -1
0 0 0 0 0 0 0 0 0 0 0 0 0 0 0 -1
-2
0 0 0 0 0 0 0 0 0 0 0 0 0 0 0 -1
0 8 8 8 8 8 1 1 8 8 8 8 8 8 0 -1
0 8 0 0 0 0 0 0 0 0 0 0 0 8 0 -1
0 8 0 0 0 0 0 0 0 0 0 0 0 8 0 -1
0 8 0 0 0 0 0 0 0 0 0 0 0 8 0 -1
0 8 0 0 0 0 0 0 0 0 0 0 0 8 0 -1
0 1 0 0 0 0 0 0 0 0 0 0 0 0 0 -1
0 1 0 0 0 0 0 0 0 0 0 0 0 0 0 -1
0 8 0 0 0 0 0 0 0 0 0 0 0 8 0 -1
0 8 0 0 0 0 0 0 0 0 0 0 0 8 0 -1
0 8 0 0 0 0 0 0 0 0 0 0 0 8 0 -1
0 8 0 0 0 0 0 0 0 0 0 0 0 8 0 -1
0 8 0 5 0 0 5 0 0 0 0 0 0 8 0 -1
0 8 8 8 5 5 8 8 8 8 8 8 8 8 0 -1
0 0 0 0 0 0 0 0 0 0 0 0 0 0 0 -1
-2
0 0 0 0 0 0 0 0 0 0 0 0 0 0 0 -1
0 8 8 8 8 1 1 1 1 8 8 8 8 8 0 -1
0 8 0 0 0 0 0 0 0 0 0 0 0 8 0 -1
0 8 0 0 0 0 0 0 0 0 0 0 0 1 0 -1
0 8 0 0 0 0 0 0 0 0 0 0 0 1 0 -1
0 1 0 0 0 0 0 0 0 0 0 0 0 8 0 -1
0 1 0 0 0 0 0 0 0 0 0 0 0 0 0 -1
0 1 0 0 0 0 0 0 0 0 0 0 0 0 0 -1
0 1 0 0 0 0 0 0 0 0 0 0 0 8 0 -1
0 8 0 0 0 0 0 0 0 0 0 0 0 1 0 -1
0 8 0 0 0 0 0 0 0 0 0 0 0 1 0 -1
0 8 0 0 5 5 0 0 0 0 0 0 0 8 0 -1
0 8 0 5 0 0 5 0 0 0 0 0 0 8 0 -1
0 8 8 8 5 5 8 8 8 8 8 8 8 8 0 -1
0 0 0 0 0 0 0 0 0 0 0 0 0 0 0 -1
-2
0 0 0 0 0 0 0 0 0 0 0 0 0 0 0 -1
0 8 8 8 8 8 1 1 8 8 8 8 8 8 0 -1
0 8 0 0 0 0 0 0 0 0 0 0 0 8 0 -1
0 8 0 0 0 0 0 0 0 0 0 0 0 8 0 -1
0 8 0 0 0 0 0 0 0 0 0 0 0 8 0 -1
0 8 0 0 0 0 0 0 0 0 0 0 0 8 0 -1
0 1 0 0 0 0 0 0 0 0 0 0 0 8 0 -1
0 1 0 0 0 0 0 0 0 0 0 0 0 8 0 -1
0 8 0 0 0 0 0 0 0 0 0 0 0 8 0 -1
0 8 0 0 0 0 0 0 0 0 0 0 0 8 0 -1
0 8 0 0 0 0 0 0 0 0 0 0 0 8 0 -1
0 8 0 0 5 5 0 0 0 0 0 0 0 8 0 -1
0 8 0 5 0 0 5 0 0 0 0 0 0 8 0 -1
0 8 8 8 5 5 8 8 8 8 8 8 8 8 0 -1
0 0 0 0 0 0 0 0 0 0 0 0 0 0 0 -1
-2
0 0 0 0 0 0 0 0 0 0 0 0 0 0 0 -1
0 8 8 8 8 8 8 8 8 8 8 8 8 8 0 -1
0 8 0 0 0 0 0 0 0 0 0 0 0 8 0 -1
0 8 0 0 0 0 0 0 0 0 0 0 0 8 0 -1
0 8 0 0 0 0 0 0 0 0 0 0 0 8 0 -1
0 8 0 0 0 0 0 0 0 0 0 0 0 8 0 -1
0 8 0 0 0 0 0 0 0 0 0 0 0 8 0 -1
0 8 0 0 0 0 0 0 0 0 0 0 0 8 0 -1
0 8 0 0 0 0 0 0 0 0 0 0 0 8 0 -1
0 8 0 0 0 0 0 0 0 0 0 0 0 8 0 -1
0 8 0 0 0 0 0 0 0 0 0 0 0 8 0 -1
0 8 0 0 5 5 0 0 0 0 0 0 0 8 0 -1
0 8 0 5 0 0 5 0 0 0 0 0 0 8 0 -1
0 8 8 8 5 5 8 8 8 8 8 8 8 8 0 -1
0 0 0 0 0 0 0 0 0 0 0 0 0 0 0 -1
-2
0 0 0 0 0 0 0 0 0 0 0 0 0 0 0 -1
0 8 8 8 8 8 8 8 8 8 8 8 8 8 0 -1
0 8 0 0 0 0 0 0 0 0 0 0 0 8 0 -1
0 8 0 0 0 0 0 0 0 0 0 0 0 8 0 -1
0 8 0 0 0 0 0 0 0 0 0 0 0 8 0 -1
0 8 0 0 0 0 0 0 0 0 0 0 0 8 0 -1
0 8 0 0 0 0 0 0 0 0 0 0 0 8 0 -1
0 8 0 0 0 0 0 0 0 0 0 0 0 8 0 -1
0 8 0 0 0 0 0 0 0 0 0 0 0 8 0 -1
0 8 0 0 0 0 0 0 0 0 0 0 0 8 0 -1
0 8 0 0 0 0 0 0 0 0 0 0 0 8 0 -1
0 8 0 0 5 5 0 0 0 0 0 0 0 8 0 -1
0 8 0 5 0 0 5 0 0 0 0 0 0 8 0 -1
0 8 8 8 5 5 8 8 8 8 8 8 8 8 0 -1
0 0 0 0 0 0 0 0 0 0 0 0 0 0 0 -1
-2
0 0 0 0 0 0 0 0 0 0 0 0 0 0 0 -1
0 0 0 0 0 0 0 0 0 0 0 0 0 0 0 -1
0 0 8 8 8 8 8 8 8 8 8 8 8 0 0 -1
0 0 8 0 0 0 0 0 0 0 0 0 8 0 0 -1
0 0 8 0 0 0 0 0 0 0 0 0 8 0 0 -1
0 0 8 0 0 0 0 0 0 0 0 0 8 0 0 -1
0 0 8 0 0 0 0 0 0 0 0 0 8 0 0 -1
0 0 8 0 0 0 0 0 0 0 0 0 8 0 0 -1
0 0 8 0 0 0 0 0 0 0 0 0 8 0 0 -1
0 0 8 0 0 0 0 0 0 0 0 0 8 0 0 -1
0 0 8 0 0 0 0 0 0 0 0 0 8 0 0 -1
0 0 8 0 5 5 0 0 0 0 0 0 8 0 0 -1
0 0 8 5 0 0 5 8 8 8 8 8 8 0 0 -1
0 0 0 0 5 5 0 0 0 0 0 0 0 0 0 -1
0 0 0 0 0 0 0 0 0 0 0 0 0 0 0 -1
-2
0 0 0 0 0 0 0 0 0 0 0 0 0 0 0 -1
0 0 0 0 0 0 0 0 0 0 0 0 0 0 0 -1
0 0 0 0 0 0 0 0 0 0 0 0 0 0 0 -1
0 0 0 8 8 8 8 8 8 8 8 8 0 0 0 -1
0 0 0 8 0 0 0 0 0 0 0 8 0 0 0 -1
0 0 0 8 0 0 0 0 0 0 0 8 0 0 0 -1
0 0 0 8 0 0 0 0 0 0 0 8 0 0 0 -1
0 0 0 8 0 0 0 0 0 0 0 8 0 0 0 -1
0 0 0 8 0 0 0 0 0 0 0 8 0 0 0 -1
0 0 0 8 0 0 0 0 0 0 0 8 0 0 0 -1
0 0 0 8 0 0 0 0 0 0 0 8 0 0 0 -1
0 0 0 8 5 5 8 8 8 8 8 8 0 0 0 -1
0 0 0 5 0 0 5 0 0 0 0 0 0 0 0 -1
0 0 0 0 0 0 0 0 0 0 0 0 0 0 0 -1
0 0 0 0 0 0 0 0 0 0 0 0 0 0 0 -1
-2
0 0 0 0 0 0 0 0 0 0 0 0 0 0 0 -1
0 0 0 0 0 0 0 0 0 0 0 0 0 0 0 -1
0 0 0 0 0 0 0 0 0 0 0 0 0 0 0 -1
0 0 0 0 0 0 0 0 0 0 0 0 0 0 0 -1
0 0 0 0 8 8 8 8 8 8 8 0 0 0 0 -1
0 0 0 0 8 0 0 0 0 0 8 0 0 0 0 -1
0 0 0 0 8 0 0 0 0 0 8 0 0 0 0 -1
0 0 0 0 8 0 0 0 0 0 8 0 0 0 0 -1
0 0 0 0 8 0 0 0 0 0 8 0 0 0 0 -1
0 0 0 0 8 0 0 0 0 0 8 0 0 0 0 -1
0 0 0 0 8 8 8 8 8 8 8 0 0 0 0 -1
0 0 0 0 5 5 0 0 0 0 0 0 0 0 0 -1
0 0 0 5 0 0 5 0 0 0 0 0 0 0 0 -1
0 0 0 0 0 0 0 0 0 0 0 0 0 0 0 -1
0 0 0 0 0 0 0 0 0 0 0 0 0 0 0 -1
-2
0 0 0 0 0 0 0 0 0 0 0 0 0 0 0 -1
0 0 0 0 0 0 0 0 0 0 0 0 0 0 0 -1
0 0 0 0 0 0 0 0 0 0 0 0 0 0 0 -1
0 0 0 0 0 0 0 0 0 0 0 0 0 0 0 -1
0 0 0 0 0 0 0 0 0 0 0 0 0 0 0 -1
0 0 0 0 0 8 8 8 8 8 0 0 0 0 0 -1
0 0 0 0 0 8 0 0 0 8 0 0 0 0 0 -1
0 0 0 0 0 8 0 0 0 8 0 0 0 0 0 -1
0 0 0 0 0 8 0 0 0 8 0 0 0 0 0 -1
0 0 0 0 0 8 8 8 8 8 0 0 0 0 0 -1
0 0 0 0 0 0 0 0 0 0 0 0 0 0 0 -1
0 0 0 0 0 0 0 0 0 0 0 0 0 0 0 -1
0 0 0 0 5 5 0 0 0 0 0 0 0 0 0 -1
0 0 0 0 0 0 0 0 0 0 0 0 0 0 0 -1
0 0 0 0 0 0 0 0 0 0 0 0 0 0 0 -1
-2
0 0 0 0 0 0 0 0 0 0 0 0 0 0 0 -1
0 0 0 0 0 0 0 0 0 0 0 0 0 0 0 -1
0 0 0 0 0 0 0 0 0 0 0 0 0 0 0 -1
0 0 0 0 0 0 0 0 0 0 0 0 0 0 0 -1
0 0 0 0 0 0 0 0 0 0 0 0 0 0 0 -1
0 0 0 0 0 0 0 0 0 0 0 0 0 0 0 -1
0 0 0 0 0 0 8 8 8 0 0 0 0 0 0 -1
0 0 0 0 0 0 8 0 8 0 0 0 0 0 0 -1
0 0 0 0 0 0 8 8 8 0 0 0 0 0 0 -1
0 0 0 0 0 0 0 0 0 0 0 0 0 0 0 -1
0 0 0 0 0 0 0 0 0 0 0 0 0 0 0 -1
0 0 0 0 0 0 0 0 0 0 0 0 0 0 0 -1
0 0 0 0 0 0 0 0 0 0 0 0 0 0 0 -1
0 0 0 0 0 0 0 0 0 0 0 0 0 0 0 -1
0 0 0 0 0 0 0 0 0 0 0 0 0 0 0 -1
-2
0 0 0 0 0 0 0 0 0 0 0 0 0 0 0 -1
0 0 0 0 0 0 0 0 0 0 0 0 0 0 0 -1
0 0 0 0 0 0 0 0 0 0 0 0 0 0 0 -1
0 0 0 0 0 0 0 0 0 0 0 0 0 0 0 -1
0 0 0 0 0 0 0 0 0 0 0 0 0 0 0 -1
0 0 0 0 0 0 0 0 0 0 0 0 0 0 0 -1
0 0 0 0 0 0 0 0 0 0 0 0 0 0 0 -1
0 0 0 0 0 0 0 8 0 0 0 0 0 0 0 -1
0 0 0 0 0 0 0 0 0 0 0 0 0 0 0 -1
0 0 0 0 0 0 0 0 0 0 0 0 0 0 0 -1
0 0 0 0 0 0 0 0 0 0 0 0 0 0 0 -1
0 0 0 0 0 0 0 0 0 0 0 0 0 0 0 -1
0 0 0 0 0 0 0 0 0 0 0 0 0 0 0 -1
0 0 0 0 0 0 0 0 0 0 0 0 0 0 0 -1
0 0 0 0 0 0 0 0 0 0 0 0 0 0 0 -1
-2